Name	Description	Edit
Jag	The universe	Edit
Jagadeep	Light of the world	Edit
Jagadish/Jagdish	Lord of the universe	Edit
Jagajeet	Conqueror of the world	Edit
Jagan	Universe	Edit
Jagannath	Lord Vishnu	Edit
Jagat	The universe	Edit
Jalendu	Moon in the water	Edit
Janak	Father of Sita	Edit
Janardan	One who helps people, Vishnu	Edit
Janu	Soul/life force	Edit
Japa	Chanting	Edit
Japendra	Lord of chants - Lord Shiva	Edit
Jaswant	Victorious (Yashwant)	Edit
Jatan	Nurturing	Edit
Jatin	Pertaining to a saint	Edit
Jawahar	Gem	Edit
Jayadev	God of victory	Edit
Jayant/Jayanta	Victorious	Edit
Jayesh	Victor	Edit
Jeevan	Life	Edit
Jishnu	Arjuna	Edit
Jitendra/Jiten	Lord of conquerers	Edit
Jiwan/Jivan	Life	Edit
Jyotindra	Lord of life	Edit
Jas	Dafdfasdfasdfsdfa	Edit
Jiyash	Soul of govinda and sushma i.e GS	Edit
Jeet bahadur taramu magar	I am a boy. I live in Thulo lumpek,Gulmi,Lumbini, Western Nepal	Edit
Joyson	Joyson	Edit
Juanitar	Juanitar	Edit
Jayaman	Please advise us the meaning of this name.
(कृपयायो नामको अर्थ हलिदिनुहोला !)	Edit
Jewish	Please advise us the meaning of this name.	Edit
Jibika	Please advise us the meaning of this name.	Edit