Name	Description	Edit
Tanuj	Please advise use the meaning of this name.	Edit
Tapan	Sun, summer	Edit
Tapas	Heat, penance	Edit
Tarak	Star, pupil of eye, protector	Edit
Taral	Liquid	Edit
Taran	Raft, heaven	Edit
Tarang	Wave	Edit
Tarini/Tarani	Boat; take ashore	Edit
Tarun	Young, youth	Edit
Tej	Bright	Edit
Tejas	Lustre; brilliance	Edit
Thakur	Leader; god	Edit
Tika	Auspicious symbol in the forehead	Edit
Tilak	Ornament, ornamental mark on forehead	Edit
Tirtha	Holy place	Edit
Toshan	Satisfaction	Edit
Tribhuvan	The tree worlds	Edit
Trilochan	Three eyed, Lord Shiva	Edit
Trilok	The three worlds (heaven, earth, hell)	Edit
Trishanku	A king of the Surya dynasty	Edit
Tufan	Storm	Edit
Tulasi/Tulsi	The sacred plant	Edit
Tushar	Winter, frost	Edit
Tyag	Sacrifice	Edit
Tshering	Tshering or Tsering is a Unisex name used both in Tibet and Nepal. It Means Long Life.	Edit
Toophan	Storm	Edit
Tulsi	Medicinal Plant; Sign of Hinduism
(कृपयायो नामको अर्थ हलिदिनुहोला !)	Edit
Tanisha	Please advise us the meaning of this name.	Edit
Tilanjal	Mixed of water and Til, a pure substance used to worship.	Edit
Tribikram	The Holy Trinity of Bhrama, Bishnu, and Maheshwor	Edit
Taehyung	Superior, Big	Edit
Teju	Please advise us the meaning of this name.	Edit
Tej Narayan	Please advise us the meaning of this name.	Edit