Name	Description	Edit
Udar	Generous	Edit
Udaya/Uday	To rise	Edit
Uddhav	Lord Krishna's friend	Edit
Udit	Grown, awakened, shining, risen	Edit
Ujesh	One who gives light	Edit
Ujwal,Ujjala	Bright	Edit
Umanga	Enthusiasm	Edit
Umesh	Lord Shiva	Edit
Unnabh	Highest	Edit
Unnat	Pregressive, energized	Edit
Upendra	Lord Vishnu	Edit
Utkarsh	Prosperity, awakening	Edit
Utkrishta	Best	Edit
Utpal	Water lily, fleshless	Edit
Utsang	Embrace	Edit
Utsarg	Dedicating	Edit
Utsav	Celebration	Edit
Uttam	Best	Edit
Uttar	Son of king Virata, north	Edit
Ullas	Happyness	Edit
Ujjwal	Bright; Brightness; Light	Edit
Ullash	Pease advise us the meaning of this name	Edit
Ujwal	Bright	Edit
Ulban	Please advise us the meaning of this name.	Edit