Name	Description	Edit
Gagan	Sky, heaven	Edit
Gajanand	Lord Ganesh	Edit
Gajendra	The king of elephants	Edit
Gambhir	Deep, serious	Edit
Ganapati	Lord Ganesh	Edit
Ganaraj	Lord of the clan	Edit
Gandharva	Celestial musician	Edit
Gandhi	Sun	Edit
Gandhik	Fragant	Edit
Ganesh	A Hindu God; son of Lord Shiva and Parvati	Edit
Gangadhar	Shiva	Edit
Gangadutt	Gift of Ganga	Edit
Gangesh	Lord Shiva	Edit
Gaurang	Fair complexioned	Edit
Gaurav	Honour, pride, respect	Edit
Gautam	Lord Buddha	Edit
Geet	Song	Edit
Ghanashyam	Lord Krishna	Edit
Giri	Mountain	Edit
Giridhar	Holder of mountains, name of Krishna	Edit
Girija	Goddess Parvati	Edit
Girindra	Lord Shiva	Edit
Giriraj	Lord of the mountains	Edit
Girish	Lord Shiva; god of mountains	Edit
Gokul	A village near Mathura	Edit
Gopal	Krishna, cowherd	Edit
Gopan	Protection	Edit
Gopesh	Lord Krishna	Edit
Gopi	Protector of cows (female)	Edit
Gorakh	Cowherd	Edit
Goral	Lovable	Edit
Gourishankar	Mt. Everest	Edit
Govinda	Lord Krishna, corherd	Edit
Grishma	Warmth, summer	Edit
Gulzarilal	Name of Lord Krishna	Edit
Guna	Virtues	Edit
Gunaratna	Jewel of virtue	Edit
Guru	Teacher, master, priest	Edit
Gurudas	Servant of the guru	Edit
Gurudutt	Gift of the guru	Edit
Gyan	Knowledge	Edit
Gyaneshwar	God of wisdom	Edit
Gyani	Could you please a boy name from both of these name?	Edit
God of death	Mangala	Edit
Goma	Goma	Edit
Gyanu; Gyani	Well-behaved, well-mannered	Edit
Gharchung	Garbage	Edit
Guddu	Please advise us the meaning of this name.
(कृपयायो नामको अर्थ हलिदिनुहोला !)	Edit
Garud	Holy Eagle	Edit