Name	Description	Edit
Paavan; Paawan	Pure, Sacred	Edit
Padam/Padma	Lotus	Edit
Padmanabha	Lord Vishnu	Edit
Palash	A flowering tree	Edit
Pallav	New leaves	Edit
Pankaj	Lotus flower	Edit
Parag/Paraag	Pollen	Edit
Parakram	Strength	Edit
Paramananda	Superlative joy	Edit
Paramesh	The supreme lord, title for Vishnu or Shiva	Edit
Parameshwar	The supreme God	Edit
Paramjeet/Paramjit	Highest success	Edit
Paranjay	Varun; Lord of the Sea	Edit
Paras/Paaras	Touchstone	Edit
Parashar	An ancient	Edit
Paresh	Supreme Lord	Edit
Parijat	A celestial flower	Edit
Parikshit	Proven; name of an ancient king	Edit
Parimal	Fragrance	Edit
Paritosh	Satisfaction, contentment	Edit
Parmesh	God	Edit
Partha	A name given to Arjun by Lord Krishna	Edit
Parul	Graceful	Edit
Parvat/Parbat	Mountain	Edit
Parvesh	Lord of celebration	Edit
Parvesh/Parwesh	Lord of celebration	Edit
Pathik	Traveller	Edit
Pavan/Pawan	Breeze	Edit
Pavitra/Pabitra	Pure	Edit
Pawan	(Paawan) pure	Edit
Phalgun	A month in Hindu Calander	Edit
Phanindra	Seshnag; the divine snake	Edit
Pitambar	Yellow robed; Lord Vishnu	Edit
Piyush	Milk, nectar	Edit
Poojan	Worship	Edit
Poojit	Worshipped	Edit
Poorna/Purna	Complete	Edit
Prabal	Very strong, mighty	Edit
Prabhakar	Sun	Edit
Prabhas	Lustrous	Edit
Prabhat	Dawn	Edit
Prabhav	Power, might, influence	Edit
Prabhu	God	Edit
Prabir	Hero, brave one (Praveer)	Edit
Prabodh	Vigilance, sound advice	Edit
Prabuddha	Awakened	Edit
Pradeep/Pradip	Light, shine	Edit
Pradyot	Lustre	Edit
Pradyumna	Cupid	Edit
Prafulla	Pleasant, cheerful	Edit
Pragun	Straight; honest	Edit
Prahalad	Bliss	Edit
Prajeet/Prajit	Victorious, king	Edit
Prajesh	Lord Brahma	Edit
Prakash	Light	Edit
Prakat	Manifest	Edit
Prakrit	Nature/ handsome	Edit
Prakul	Good-looking	Edit
Pramesh	Master of accurate knowledge	Edit
Pramit	Consciousness	Edit
Pramod	Delight, happyness	Edit
Pran/Praan	Vital breath, life	Edit
Pranav	Romance; The sacred syllable OM	Edit
Pranay	Love, romance	Edit
Pranit	Modest	Edit
Prasad	Offering to god during pooja	Edit
Prasanna	Cheerful, pleased	Edit
Prasata	Father of Draupad	Edit
Prashant/Prashanta	Calm and composed	Edit
Prasoon/Prasun	Flower	Edit
Pratap	Dignity, majesty, glory	Edit
Pratik	Symbol	Edit
Pratit/Prateet	Manifested	Edit
Pratosh	Delight	Edit
Praval/Prawal/Prabal	Fierce, strong	Edit
Praveen/Pravin/Prabin	Expert, skilled	Edit
Pravir	Brave	Edit
Prayag	Confluence of Ganga-Jamuna-Saraswati	Edit
Prem	Love	Edit
Premal	Full of love	Edit
Pritam	Beloved, lover	Edit
Prithu	A king from the epics	Edit
Prithvi/Prithivi	The earth	Edit
Pritish	Lord of love	Edit
Pujit	Worshipped	Edit
Punit/Puneet	Pure, auspicious, holy	Edit
Purna/Poorna	Complete	Edit
Purnendu	Full moon	Edit
Puru	A legendary King	Edit
Purushottam	Best among men	Edit
Pushkar	Lotus; a lake	Edit
Prabin	Knowledge	Edit
Prusutam	Prusutam is name of load ram name	Edit
Prince vivekananda itani	Boy ggggggggggggijjjjjjjjjjjjjjjjjj kkkkkkkkkkkkkkkkkkkkkkkkkkkkkkkkkkkkkkkkh h	Edit
Prattyush	Delightful morning	Edit
Prayash	Basu	Edit
Pradeep	Hajur	Edit
Prayan	Supreme Inteligence	Edit
Peshal	Clever, Wise, Beautiful	Edit
Prithak	Different from other	Edit
Pushpraj	King of flowers	Edit
Priya tamang	Fnewkf	Edit
Priyam	Hero of epic	Edit
Prakhyat	Famous	Edit
Paryas	To try	Edit
Prachanda	Good counseling , honesty , he can motivated others	Edit
Pradhumna	Son Of Lord Krishn	Edit
Pranish	Please advise us the meaning of this name.
(कृपयायो नामको अर्थ हलिदिनुहोला !)	Edit
Praveen	Please advise us the meaning of this name.
(कृपयायो नामको अर्थ हलिदिनुहोला !)	Edit
Padam	Please advise us the meaning of this name.
(कृपयायो नामको अर्थ हलिदिनुहोला !)	Edit
Prashant	Please advise us the meaning of this name
(कृपयायो नामको अर्थ हलिदिनुहोला !)	Edit
Prasiddha	Famous; Popular	Edit
Prayasi	Pease advise us the meaning of this name
(कृपयायो नामको अर्थ हलिदिनुहोला !)	Edit
Pasang	Pease advise us the meaning of this name	Edit
Prasid	Pease advise us the meaning of this name	Edit
Pappu	Please advise us the meaning of this name.	Edit
Prasun	Please advise us the meaning of this name.	Edit
Parjun	Please advise us the meaning of this name.	Edit
Prajit	Please advise us the meaning of this name.	Edit
Pratiman	Please advise us the meaning of this name.	Edit
Prankit	Please advise us the meaning of this name.	Edit
Pranjol	Please advise us the meaning of this name!	Edit
Prayankar	Divine	Edit
Prakshin	Manifestation of lord Shiva.
(भगवान शिवको अर्को रुप)	Edit
Prijan	Please advise us the meaning of this name.	Edit