Name	Description	Edit
Kabir	Name of a famous poet-saint	Edit
Kailash	Abode of Lord Shiva	Edit
Kalash	Sacred pot	Edit
Kalidas	The poet, musician, a devotee of Goddess Kali	Edit
Kalyan	Welfare	Edit
Kamadev	God of love	Edit
Kamalesh	Lord Vishnu, one with eyes like a lotus	Edit
Kamlesh	God of lotus	Edit
Kanak	Gold	Edit
Kanan	A garden, forest	Edit
Kanhaiya	Lord Krishna	Edit
Kapil	Name of a sage	Edit
Karna	The first-born son of Kunti; ear	Edit
Kartik	A Hindu month	Edit
Kartikeya	Elder son of Lord Shiva	Edit
Karunakar	Merciful	Edit
Kashi	Name of Varanasi	Edit
Kashyap	Name of a sage	Edit
Kaushal	Clever, skilled	Edit
Kaushik	Sage Vishwamitra	Edit
Kavi/Kabi	Poet	Edit
Kavin	Handsome/beautiful	Edit
Kedar	Mountain lord, powerful	Edit
Kesar	Saffron	Edit
Keshab/Keshav	Krishna's name	Edit
Ketak	Flower	Edit
Ketan	Pure gold	Edit
Kewal	Only	Edit
Khagendra	Lord of the birds	Edit
Khem	Welfare; Peace Loving	Edit
Kirtan	Songs of worship	Edit
Kishor/Kishore	A young boy	Edit
Kripal	Merciful	Edit
Krishna	Lord Krishna	Edit
Kuber	God of riches	Edit
Kuldeep	Light of family	Edit
Kumar	Young boy, prince	Edit
Kunal	Son of King Ashoka	Edit
Kundan	Gold, pure	Edit
Kush/Kusha	Son of Lord Rama	Edit
Kathmandu	Name of capital city in Nepal.	Edit
Kalu	Kalu malu	Edit
Kul	Please advise us the meaning of this name.
(कृपयायो नामको अर्थ हलिदिनुहोला !)	Edit
Kharka	Shord	Edit
Kirshal	Please advise us the meaning of this name.
(कृपयायो नामको अर्थ हलिदिनुहोला !)	Edit
Krishab	Lord Krishna	Edit
Kevin	Please advise us the meaning of this name.	Edit