Name	Description	Edit
Labh	Gain	Edit
Lagan	Dedication; appropriate time	Edit
Lahar	Wave	Edit
Lakshman	Brother of Lord Rama	Edit
Lalit	Beautiful	Edit
Lav/Lava	Son of Lord Rama	Edit
Layak	Capable	Edit
Lekh	Document	Edit
Lila/Leela	Divine drama	Edit
Lochan	The eye	Edit
Lokesh	Lord Brahma	Edit
Loknath	Lord Vishnu	Edit
Lightro	Meaning is run very fast or super fast	Edit
Loken	Divergent	Edit
Lila	Please advise us the meaning of this name.
(कृपयायो नामको अर्थ हलिदिनुहोला !)	Edit
Laxman	In Sanskrit: "having lucky marks". In the Hindu epic the 'Ramayana' he is the trusted companion of the hero Rama, accompanying him into exile.	Edit
Lachee	Please advise us the meaning of this name.
(कृपयायो नामको अर्थ हलिदिनुहोला !)	Edit
Lokendra	Please advise us the meaning of this name.
(कृपयायो नामको अर्थ हलिदिनुहोला !)	Edit
Lelish	Please advise us the meaning of this name.	Edit