Name	Description	Edit
Hans	Swan	Edit
Hanuman	The monkey god of Ramayana	Edit
Hardik	Heartfelt	Edit
Harendra	Lord Shiva	Edit
Haresh	Shiva	Edit
Hari	Vishnu	Edit
Harigopal	Lord Krishna	Edit
Harihar	Shiva and Vishnu together	Edit
Harinarayan	Lord Vishnu	Edit
Harindra	Lord Shiva	Edit
Harish	Vishnu	Edit
Harishankar	Vishnu and Shiva	Edit
Harishchandra	King of Surya dynasty, charitable	Edit
Harmendra	The moon	Edit
Harsha	Joy, happiness	Edit
Harshad	Happy	Edit
Harshil	Joyful	Edit
Harshit	Joyful	Edit
Hasan	Laughter	Edit
Hasit	Happy	Edit
Hemachandra	Golden moon	Edit
Hemanga	Golden coloured	Edit
Hemant	Winter	Edit
Hemendra	Lord of gold	Edit
Hemendu	Golden moon	Edit
Hemish	Lord of the earth	Edit
Heramba	Lord Ganesh	Edit
Himachal	The Himalayas	Edit
Himadri	Himalaya	Edit
Himaghna	The sun	Edit
Himal	Snow mountain	Edit
Himanshu	Moon	Edit
Himmat	Courage	Edit
Hira/Heera	Diamond	Edit
Hiranmay	Golden, wealth	Edit
Hiranya	Wealth	Edit
Hirendra	Lord of diamonds	Edit
Hiresh	King of precious stones	Edit
Hiten	Well wisher	Edit
Hitendra	Well wisher	Edit
Hitesh	Well wisher	Edit
Hridaya	The heart	Edit
Hridayesh	King of heart	Edit
Hrishikesh/Rishikesh	Lord Vishnu, one who controls senses	Edit
Hghgh	Hghghgh	Edit
Hira	Dimond, Precious, Worthy	Edit
Harischandra	Dfasd	Edit
Hem subedi	Himalayan snow	Edit
Harmesh	Always	Edit
Hakku	Hakku	Edit
Harka	Please Advise Us the Meaning of this name.
(खुसि हुनु)	Edit