Name	Description	Edit
Dakshesh	Shiva	Edit
Dakshi	The glorious	Edit
Daman	One who controls	Edit
Damodar	Lord Ganapati	Edit
Danbir/Danvir	Charitable	Edit
Darpak	Kamdev, god of love	Edit
Darpan	A mirror	Edit
Darshan	Vision, sight, paying respect	Edit
Dasharath	The father of Lord Rama	Edit
Dattatreya	A son of Atri, a god	Edit
Dayanand	One who likes being merciful	Edit
Debashis/Devashish	The Lord's blessing	Edit
Debjit; Devjit	One who has conquered Gods	Edit
Deenabandhu	Friend of the poor	Edit
Deep	A lamp, light	Edit
Deepak/Dipak	Light	Edit
Deepan	Lighting up	Edit
Deepankar	Lord of light	Edit
Deependra; Dipendra	Lord of light	Edit
Deependu	Bright moon	Edit
Deepesh/Dipesh	Deep means Light and Eesh means Lord or god. Therefore, it means god of light	Edit
Deepit	Lighted	Edit
Deeptanshu	The sun	Edit
Dev; Deb	God, king	Edit
Devabrata	A name of Bhisma	Edit
Devaj	From God	Edit
Devajyoti	Brightness of the Lord	Edit
Devak	Divine	Edit
Devanand	Joy of God	Edit
Devang	From God	Edit
Devarsi	Sage of the Devas	Edit
Devdarsh	Worshipper of God	Edit
Devdas	Follower of God	Edit
Devendra/Debendra	Lord Indra	Edit
Devesh	God of gods	Edit
Devesh/Debesh	God of gods	Edit
Deveshwar	Lord Shiva	Edit
Devrat	Spiritual	Edit
Dhairya	Patience	Edit
Dhana/Dhan	Wealth	Edit
Dhananjay	One who wins wealth, Arjun	Edit
Dhanesh	Lord of wealth	Edit
Dharanidhar	Sheshnaag - the cosmic serpent	Edit
Dharma	Religion, nature	Edit
Dharmapal	Protector of his religion	Edit
Dharmendra	King of religion	Edit
Dharmendu	Light of religion	Edit
Dharmesh	Master of religion	Edit
Dharuna	A rishi	Edit
Dhatri	A son of Vishnu/Lakshmi	Edit
Dhawal	White, fair complexioned	Edit
Dheeman	Intelligent	Edit
Dheemant	Wise; intelligent	Edit
Dheerendra/Dhirendra	God of courage, lord of the brave	Edit
Dhimant	Intelligent	Edit
Dhir/Dheer	Tolerant, wise	Edit
Dhiraj	Patience	Edit
Dhiren	One who is strong	Edit
Dhritiman	Patient	Edit
Dhruba	The polar star, firm, unshakable	Edit
Dhyan	Meditation	Edit
Dhyanesh	Meditative	Edit
Dhyaneshwar	Lord of meditation	Edit
Dibya/Divya	Heavenly, brilliant	Edit
Digambar	Unencumbered, free, naked	Edit
Dilawar	Brave	Edit
Dilip, Dileep	A king, ancestor of Rama	Edit
Dinakar	The sun	Edit
Dinendra	Lord of the day, the sun	Edit
Dinesh	Sun	Edit
Dinkar	Sun	Edit
Dipendra	Lord of lights	Edit
Dipendu	Moon	Edit
Dipesh	Lord of light	Edit
Diptanshu	Sun	Edit
Divendu, Divyendu, Dibyendu	The moon	Edit
Divyesh	Full of divinity	Edit
Diwakar/Divakar	Sun	Edit
Durgesh	Lord of forts	Edit
Durjaya	Difficult to conquer	Edit
Dushyanta	A king from the epic Mahabharata, destroyer of evil	Edit
Dwaipayan	The sage Vyasa	Edit
Dwarika	Capital of Lord Krishna's kingdom	Edit
Dwijendra/Dwijaraj	King of Brahmins; the moon	Edit
Dwijesh	River	Edit
Diwash	Day	Edit
Dhanlal lama	RIchaa SInjee	Edit
Dhangadhi nepal	HARI	Edit
Dhangadhi	THA SUN	Edit
DOTI DIPAYEL	THA SUN	Edit
DELHI	THA SUN	Edit
Dilli	King	Edit
Dhana lama	I am haven	Edit
Deepak	Light	Edit
Dipesh / Deepesh	Deep means Light and Eesh means Lord or god. Threfore, Dipesh or Deepesh means Lord of the Lights	Edit
Darsh	Lord Krishna	Edit
Dorji	Dirji fight	Edit
Dilip kunwat	Sampurna life ko barema	Edit
Dipson	Pease advise us the meaning of this name	Edit
Dipersan	Please advise us the meaning of this name.
(कृपयायो नामको अर्थ हलिदिनुहोला !)	Edit
Darsang	Please Advise Us the Meaning of this name.
(कृपयायो नामको अर्थ हलिदिनुहोला !)	Edit
Dhan	Wealth; Prosperity	Edit
Dhrishya	Vision	Edit
Dharmaraj	Please advise us the meaning of this name.
(कृपयायो नामको अर्थ हलिदिनुहोला !)	Edit
Dhandhoj	Please advise us the meaning of this name.	Edit
Dhurba	Please advise us the meaning of this name.	Edit
Darma	In Hinduism and Buddhism it means 'duty', 'virtue', 'morality', even 'religion' and it refers to the power which upholds the universe and society	Edit