Name	Description	Edit
Yogi/Yogita	Devotee	Edit
Yougal	Couple / Jodi
(जोडी)	Edit
Yuddha/Juddha	War	Edit
Yuvaraj	Prince, heir apparent
(राजकुमार)	Edit
Yadab/Yadav	Lord Krishna	Edit
Yadunath	Lord Krishna	Edit
Yagya	Holy ceremony	Edit
Yash	Fame	Edit
Yatindra	Lord Indra	Edit
Yatish	Lord of devotees	Edit
Yogendra	God of Yoga	Edit
Yogesh	God of Yoga, Lord Shiva	Edit
Yogi	Devotee	Edit
Yam kumar batas	Jst jokra	Edit
Yalamber	1st Kirati King of Nepal	Edit
Yubin	Yubin	Edit
Yam	Please advise us the meaning of this name.
(कृपयायो नामको अर्थ हलिदिनुहोला !)	Edit
Yama	Please advise us the meaning of this name.
(कृपयायो नामको अर्थ हलिदिनुहोला !)	Edit
Yamaraj	Lord of Death	Edit
Yojak	Unique from others	Edit
Yubraj	Please advise us the meaning of this name.	Edit